11111111111
1E100000001
10100101001
10111100101
1P00C100011
11111111111